11111111111111111111111111111111111111111111111
1E00C1000001000C00000C0010001000000000000000001
10000001001P00001010010C0C100101000000000000001
10100000010101000000010000000000000000000000001
10100000010101000000010011100000000000000000001
10100000010101000000010011100000000000000000001
10100000010101000000010011100000000000000000011
10100000010101000000010011100000000000000000001
10100000010101000000010011100000000000000000111
10100000010101000000010011100000000000000000001
10100000010101000000010011100000000000001111111
10100000010101000000010011100000000000000000111
10100000000000000000000000000000000000000011111
10100000010101000000010011100000000000000000001
10100000010101000000010011100000000000000000001
10100000010101000000010011100000000000000000001
10100000010101000000010011100000CCCC00000000001
10100000010101000000010011100000000000000001111
10100000000000000000000000000000000000000000111
10100000010101000000010011100000CCCC00000000001
10100000010101000000010011100000000000000001111
10100000000000000000000000000000000000000000111
10100000010101000000010011100000CCCC00000000001
10100000010101000000010011100000000000000001111
10100000000000000000000000000000000000000000111
10100000010101000000010011100000CCCC00000000001
10100000010101000000010011100000000000000001111
10100000000000000000000000000000000000000000111
10100000010101000000010011100000CCCC00000000001
10100000010101000000010011100000000000000001111
10100000000000000000000000000000000000000000111
11111111111111111111111111111111111111111111111