1111111111111111111111111111111111
10000000C00000000000000001C1000001
1000000000000011000000000010000001
1000CC00000000E10000C0000C000CC001
1P0000000C000010000000C00000000001
1111111111111111111111111111111111