111111111
1C000C001
100001001
1P001E111
111111111