1111111111
1C11000001
1000011111
1P000E0001
10C0010C01
1111111111