11111111111
1ECP0000X01
11111111111