1111111111
1E000000P1
1000000001
1111111111