1111111111
1C11000001
1000011111
1P00E00001
10C0010C01
1111111111
