11111
10CP1
1X111
100E1
11111
