1111111111111111111111111111111111
1000000000000000C00000000000000001
10P00011111110000000000000C00000E1
1000000000000000000000000000000001
10000C0000111000000111111000000001
10000000000C1000000000000000000001
1000000000011000000001111111100001
1000000C11111000000000000000100001
100000001C001000001000000000100001
10000000100C1000001000000000100001
10000000100010000010000000C0100001
1000000010011000001000000000100001
1000111110001000001C00000000000001
100C000000001000001000000000000001
1000000000001000000000000011110001
10000000C00010000000000001100C0001
1111111111111111111111111111111111