1111111111111111111111111111111111
10000000000000000000000001C1000001
1000000000000011000000000010000001
10000000000000E0000000000000000001
1P00000000000010000000000000000001
1111111111111111111111111111111111