1111111111111111111111111111111111
1C00E1000001000C000000000000100001
11100001001000001010010CCC00010101
1010000001010100000001000000010101
1P0000000C00C0000010011110010000C1
1111111111111111111111111111111111