1111111111111111111111111111111111
1P1C100000000000C000000100011CC001
10100011111110000001111101C11111C1
10001110000000111101C0000100000001
10111C0100111010C10111111111111001
101C110C100C1010000000CC0000000101
1010001C00C11011111001111111100101
100010111111100000100C01CC00101101
1001C01C1C00100100101101C010100101
1001000001101000000001000010110001
1001111011000001001001C01010100101
1010000000011011CC1101111010100101
1001111111111001111E01000010010101
101CC00000001011CC1101C100010001C1
10011111111010011010C101001C110111
10000000C000110000100001C11C0C0001
1111111111111111111111111111111111